{
  "levelNumber": 3,
  "name": "關卡 3 - 森林迷宮",
  "description": "在濃密的森林中戰鬥，視線受限，考驗你的反應能力",

  "playerSpawn": { "x": 8, "y": 24 },
  "basePosition": { "x": 12, "y": 24 },

  "enemySpawns": [
    { "x": 0, "y": 0 },
    { "x": 12, "y": 0 },
    { "x": 24, "y": 0 }
  ],

  "enemyWaves": [
    { "type": "BASIC", "count": 5, "spawnInterval": 3000 },
    { "type": "FAST", "count": 5, "spawnInterval": 3500 },
    { "type": "POWER", "count": 3, "spawnInterval": 4000 },
    { "type": "ARMOR", "count": 2, "spawnInterval": 5000 }
  ],

  "map": [
    [0,0,0,0,0,0,0,0,0,0,0,0,0,0,0,0,0,0,0,0,0,0,0,0,0,0],
    [0,5,5,5,5,0,0,2,2,0,0,5,5,5,5,0,0,2,2,0,0,5,5,5,5,0],
    [0,5,5,5,5,0,0,2,2,0,0,5,5,5,5,0,0,2,2,0,0,5,5,5,5,0],
    [0,5,5,5,5,0,0,0,0,0,0,5,5,5,5,0,0,0,0,0,0,5,5,5,5,0],
    [0,5,5,5,5,0,0,0,0,0,0,5,5,5,5,0,0,0,0,0,0,5,5,5,5,0],
    [0,0,0,0,0,0,1,1,1,1,0,0,0,0,0,0,1,1,1,1,0,0,0,0,0,0],
    [0,0,0,0,0,0,1,1,1,1,0,0,0,0,0,0,1,1,1,1,0,0,0,0,0,0],
    [5,5,5,0,0,0,0,0,0,0,0,5,5,5,5,0,0,0,0,0,0,0,5,5,5,5],
    [5,5,5,0,0,0,0,0,0,0,0,5,5,5,5,0,0,0,0,0,0,0,5,5,5,5],
    [5,5,5,0,0,0,0,0,0,0,0,5,5,5,5,0,0,0,0,0,0,0,5,5,5,5],
    [0,0,0,0,0,2,2,0,0,0,0,0,0,0,0,0,0,0,2,2,0,0,0,0,0,0],
    [0,0,0,0,0,2,2,0,0,0,0,0,0,0,0,0,0,0,2,2,0,0,0,0,0,0],
    [0,5,5,5,5,0,0,0,0,1,1,1,1,1,1,0,0,0,0,5,5,5,5,0,0,0],
    [0,5,5,5,5,0,0,0,0,1,1,1,1,1,1,0,0,0,0,5,5,5,5,0,0,0],
    [0,5,5,5,5,0,0,0,0,0,0,0,0,0,0,0,0,0,0,5,5,5,5,0,0,0],
    [0,5,5,5,5,0,0,4,4,0,0,0,0,0,0,4,4,0,0,5,5,5,5,0,0,0],
    [0,0,0,0,0,0,0,4,4,0,0,0,0,0,0,4,4,0,0,0,0,0,0,0,0,0],
    [0,0,0,0,0,0,0,0,0,0,5,5,5,5,0,0,0,0,0,0,0,0,0,0,0,0],
    [0,0,0,0,0,0,0,0,0,0,5,5,5,5,0,0,0,0,0,0,0,0,0,0,0,0],
    [5,5,5,0,0,0,0,0,0,0,5,5,5,5,0,0,0,0,0,0,0,5,5,5,0,0],
    [5,5,5,0,0,0,0,0,0,0,0,0,0,0,0,0,0,0,0,0,0,5,5,5,0,0],
    [5,5,5,0,0,0,0,0,0,0,0,0,0,0,0,0,0,0,0,0,0,5,5,5,0,0],
    [0,0,0,0,0,0,0,0,0,0,0,0,0,0,0,0,0,0,0,0,0,0,0,0,0,0],
    [0,0,0,0,0,0,0,0,0,0,0,1,1,1,0,0,0,0,0,0,0,0,0,0,0,0],
    [0,0,0,0,0,0,0,0,0,0,0,1,6,1,0,0,0,0,0,0,0,0,0,0,0,0],
    [0,0,0,0,0,0,0,0,0,0,0,1,1,1,0,0,0,0,0,0,0,0,0,0,0,0]
  ],

  "specialRules": {
    "maxEnemiesOnScreen": 4,
    "baseProtection": false,
    "timeLimit": 0,
    "powerUpChance": 0.2
  },

  "tips": [
    "森林會遮蔽坦克的視線",
    "裝甲坦克需要 4 發子彈",
    "善用森林躲避敵人攻擊",
    "敵人數量增加，保持警惕"
  ]
}
