{
  "levelNumber": 4,
  "name": "關卡 4 - 地形大師",
  "description": "所有地形混合的終極考驗，需要靈活運用各種戰術",

  "playerSpawn": { "x": 5, "y": 24 },
  "basePosition": { "x": 12, "y": 24 },

  "enemySpawns": [
    { "x": 0, "y": 0 },
    { "x": 12, "y": 0 },
    { "x": 24, "y": 0 }
  ],

  "enemyWaves": [
    { "type": "BASIC", "count": 4, "spawnInterval": 2500 },
    { "type": "FAST", "count": 6, "spawnInterval": 3000 },
    { "type": "POWER", "count": 4, "spawnInterval": 3500 },
    { "type": "ARMOR", "count": 3, "spawnInterval": 4000 }
  ],

  "map": [
    [0,0,0,0,0,0,0,0,0,0,0,0,0,0,0,0,0,0,0,0,0,0,0,0,0,0],
    [0,4,4,4,0,0,3,3,3,0,0,2,2,0,0,3,3,3,0,0,4,4,4,0,0,0],
    [0,4,4,4,0,0,3,3,3,0,0,2,2,0,0,3,3,3,0,0,4,4,4,0,0,0],
    [0,4,4,4,0,0,3,3,3,0,0,0,0,0,0,3,3,3,0,0,4,4,4,0,0,0],
    [0,0,0,0,0,0,0,0,0,0,0,0,0,0,0,0,0,0,0,0,0,0,0,0,0,0],
    [0,0,5,5,5,5,0,0,1,1,1,1,1,1,0,0,5,5,5,5,0,0,0,0,0,0],
    [0,0,5,5,5,5,0,0,1,1,1,1,1,1,0,0,5,5,5,5,0,0,0,0,0,0],
    [0,0,5,5,5,5,0,0,0,0,0,0,0,0,0,0,5,5,5,5,0,0,0,0,0,0],
    [3,3,0,0,0,0,0,0,0,0,2,2,0,0,0,0,0,0,0,0,3,3,3,3,3,3],
    [3,3,0,0,0,0,0,0,0,0,2,2,0,0,0,0,0,0,0,0,3,3,3,3,3,3],
    [3,3,0,0,4,4,4,4,0,0,0,0,0,0,4,4,4,4,0,0,3,3,3,3,3,3],
    [0,0,0,0,4,4,4,4,0,0,0,0,0,0,4,4,4,4,0,0,0,0,0,0,0,0],
    [0,0,0,0,4,4,4,4,0,0,0,0,0,0,4,4,4,4,0,0,0,0,0,0,0,0],
    [0,0,0,0,0,0,0,0,0,0,2,2,0,0,0,0,0,0,0,0,0,0,0,0,0,0],
    [0,5,5,5,0,0,0,0,0,0,2,2,0,0,0,0,0,0,0,5,5,5,0,0,0,0],
    [0,5,5,5,0,0,3,3,3,3,0,0,3,3,3,3,0,0,0,5,5,5,0,0,0,0],
    [0,5,5,5,0,0,3,3,3,3,0,0,3,3,3,3,0,0,0,5,5,5,0,0,0,0],
    [0,0,0,0,0,0,3,3,3,3,0,0,3,3,3,3,0,0,0,0,0,0,0,0,0,0],
    [0,0,0,0,0,0,0,0,0,0,0,0,0,0,0,0,0,0,0,0,0,0,0,0,0,0],
    [4,4,4,4,0,0,0,0,0,0,1,1,1,1,0,0,0,0,0,0,4,4,4,4,0,0],
    [4,4,4,4,0,0,0,0,0,0,1,1,1,1,0,0,0,0,0,0,4,4,4,4,0,0],
    [4,4,4,4,0,0,0,0,0,0,1,1,1,1,0,0,0,0,0,0,4,4,4,4,0,0],
    [0,0,0,0,0,0,0,0,0,0,0,0,0,0,0,0,0,0,0,0,0,0,0,0,0,0],
    [0,0,0,0,0,0,0,0,0,0,0,1,1,1,0,0,0,0,0,0,0,0,0,0,0,0],
    [0,0,0,0,0,0,0,0,0,0,0,1,6,1,0,0,0,0,0,0,0,0,0,0,0,0],
    [0,0,0,0,0,0,0,0,0,0,0,1,1,1,0,0,0,0,0,0,0,0,0,0,0,0]
  ],

  "specialRules": {
    "maxEnemiesOnScreen": 4,
    "baseProtection": false,
    "timeLimit": 0,
    "powerUpChance": 0.22
  },

  "tips": [
    "地形混合複雜，需要靈活應對",
    "利用冰地快速移動",
    "水域可以當作天然屏障",
    "森林提供絕佳的伏擊點"
  ]
}
