{
  "levelNumber": 5,
  "name": "關卡 5 - 終極戰場",
  "description": "最後的挑戰！大量敵人與複雜地形的終極考驗",

  "playerSpawn": { "x": 6, "y": 24 },
  "basePosition": { "x": 12, "y": 24 },

  "enemySpawns": [
    { "x": 0, "y": 0 },
    { "x": 12, "y": 0 },
    { "x": 24, "y": 0 }
  ],

  "enemyWaves": [
    { "type": "BASIC", "count": 3, "spawnInterval": 2000 },
    { "type": "FAST", "count": 7, "spawnInterval": 2500 },
    { "type": "POWER", "count": 6, "spawnInterval": 3000 },
    { "type": "ARMOR", "count": 5, "spawnInterval": 3500 }
  ],

  "map": [
    [0,0,0,0,0,0,0,0,0,0,0,0,0,0,0,0,0,0,0,0,0,0,0,0,0,0],
    [0,2,2,0,5,5,5,0,3,3,3,3,3,3,0,5,5,5,0,2,2,0,0,0,0,0],
    [0,2,2,0,5,5,5,0,3,3,3,3,3,3,0,5,5,5,0,2,2,0,0,0,0,0],
    [0,0,0,0,5,5,5,0,3,3,3,3,3,3,0,5,5,5,0,0,0,0,0,0,0,0],
    [4,4,4,4,0,0,0,0,0,0,0,0,0,0,0,0,0,0,4,4,4,4,4,4,4,4],
    [4,4,4,4,0,0,0,0,0,0,2,2,0,0,0,0,0,0,4,4,4,4,4,4,4,4],
    [4,4,4,4,0,0,1,1,1,0,2,2,0,1,1,1,0,0,4,4,4,4,4,4,4,4],
    [0,0,0,0,0,0,1,1,1,0,0,0,0,1,1,1,0,0,0,0,0,0,0,0,0,0],
    [3,3,3,0,0,0,0,0,0,0,0,0,0,0,0,0,0,0,0,3,3,3,3,3,3,3],
    [3,3,3,0,0,5,5,5,5,0,0,2,0,0,5,5,5,5,0,3,3,3,3,3,3,3],
    [3,3,3,0,0,5,5,5,5,0,0,2,0,0,5,5,5,5,0,3,3,3,3,3,3,3],
    [0,0,0,0,0,5,5,5,5,0,0,0,0,0,5,5,5,5,0,0,0,0,0,0,0,0],
    [0,0,0,0,0,0,0,0,0,0,0,0,0,0,0,0,0,0,0,0,0,0,0,0,0,0],
    [0,4,4,4,4,4,0,0,0,1,1,1,1,1,0,0,0,4,4,4,4,4,0,0,0,0],
    [0,4,4,4,4,4,0,0,0,1,1,1,1,1,0,0,0,4,4,4,4,4,0,0,0,0],
    [0,4,4,4,4,4,0,0,0,0,0,0,0,0,0,0,0,4,4,4,4,4,0,0,0,0],
    [0,0,0,0,0,0,0,0,3,3,3,0,3,3,3,0,0,0,0,0,0,0,0,0,0,0],
    [5,5,5,0,0,0,0,0,3,3,3,0,3,3,3,0,0,0,0,0,5,5,5,5,5,5],
    [5,5,5,0,0,0,0,0,3,3,3,0,3,3,3,0,0,0,0,0,5,5,5,5,5,5],
    [5,5,5,0,0,0,0,0,0,0,0,0,0,0,0,0,0,0,0,0,5,5,5,5,5,5],
    [0,0,0,0,0,4,4,4,4,0,0,0,0,0,4,4,4,4,0,0,0,0,0,0,0,0],
    [0,0,0,0,0,4,4,4,4,0,0,0,0,0,4,4,4,4,0,0,0,0,0,0,0,0],
    [0,0,0,0,0,4,4,4,4,0,0,0,0,0,4,4,4,4,0,0,0,0,0,0,0,0],
    [0,0,0,0,0,0,0,0,0,0,0,1,1,1,0,0,0,0,0,0,0,0,0,0,0,0],
    [0,0,0,0,0,0,0,0,0,0,0,1,6,1,0,0,0,0,0,0,0,0,0,0,0,0],
    [0,0,0,0,0,0,0,0,0,0,0,1,1,1,0,0,0,0,0,0,0,0,0,0,0,0]
  ],

  "specialRules": {
    "maxEnemiesOnScreen": 5,
    "baseProtection": false,
    "timeLimit": 0,
    "powerUpChance": 0.25
  },

  "tips": [
    "這是最後的關卡，全力以赴！",
    "敵人數量眾多，優先保護基地",
    "善用所有地形優勢",
    "道具出現率提高，把握機會"
  ]
}
