{
  "levelNumber": 2,
  "name": "關卡 2 - 水與冰",
  "description": "學習應對水域阻擋和冰地滑行的挑戰",

  "playerSpawn": { "x": 8, "y": 24 },
  "basePosition": { "x": 12, "y": 24 },

  "enemySpawns": [
    { "x": 0, "y": 0 },
    { "x": 12, "y": 0 },
    { "x": 24, "y": 0 }
  ],

  "enemyWaves": [
    { "type": "BASIC", "count": 6, "spawnInterval": 3500 },
    { "type": "FAST", "count": 4, "spawnInterval": 4000 },
    { "type": "POWER", "count": 2, "spawnInterval": 5000 }
  ],

  "map": [
    [0,0,0,0,0,0,0,0,0,0,0,0,0,0,0,0,0,0,0,0,0,0,0,0,0,0],
    [0,0,0,0,0,0,0,0,0,0,0,0,0,0,0,0,0,0,0,0,0,0,0,0,0,0],
    [0,0,1,1,0,0,0,0,0,0,3,3,3,3,0,0,0,0,0,0,1,1,0,0,0,0],
    [0,0,1,1,0,0,0,0,0,0,3,3,3,3,0,0,0,0,0,0,1,1,0,0,0,0],
    [0,0,0,0,0,0,0,0,0,0,3,3,3,3,0,0,0,0,0,0,0,0,0,0,0,0],
    [0,0,0,0,0,0,0,0,0,0,3,3,3,3,0,0,0,0,0,0,0,0,0,0,0,0],
    [0,0,0,0,4,4,4,0,0,0,0,0,0,0,0,0,4,4,4,0,0,0,0,0,0,0],
    [0,0,0,0,4,4,4,0,0,0,0,0,0,0,0,0,4,4,4,0,0,0,0,0,0,0],
    [0,0,0,0,4,4,4,0,0,0,0,2,2,0,0,0,4,4,4,0,0,0,0,0,0,0],
    [0,0,0,0,0,0,0,0,0,0,0,2,2,0,0,0,0,0,0,0,0,0,0,0,0,0],
    [0,0,0,3,3,3,0,0,0,0,0,0,0,0,0,0,0,3,3,3,0,0,0,0,0,0],
    [0,0,0,3,3,3,0,0,0,0,0,0,0,0,0,0,0,3,3,3,0,0,0,0,0,0],
    [0,0,0,3,3,3,0,0,0,0,0,0,0,0,0,0,0,3,3,3,0,0,0,0,0,0],
    [0,0,0,0,0,0,0,0,0,0,1,1,1,1,0,0,0,0,0,0,0,0,0,0,0,0],
    [0,0,5,5,0,0,0,0,0,0,1,1,1,1,0,0,0,0,0,0,5,5,0,0,0,0],
    [0,0,5,5,0,0,0,4,4,4,4,0,0,4,4,4,4,0,0,0,5,5,0,0,0,0],
    [0,0,0,0,0,0,0,4,4,4,4,0,0,4,4,4,4,0,0,0,0,0,0,0,0,0],
    [0,0,0,0,0,0,0,4,4,4,4,0,0,4,4,4,4,0,0,0,0,0,0,0,0,0],
    [0,0,0,0,0,0,0,0,0,0,0,0,0,0,0,0,0,0,0,0,0,0,0,0,0,0],
    [0,0,0,0,0,0,0,0,0,0,0,0,0,0,0,0,0,0,0,0,0,0,0,0,0,0],
    [1,1,0,0,0,0,0,0,0,0,3,3,3,3,0,0,0,0,0,0,0,0,1,1,0,0],
    [1,1,0,0,0,0,0,0,0,0,3,3,3,3,0,0,0,0,0,0,0,0,1,1,0,0],
    [0,0,0,0,0,0,0,0,0,0,3,3,3,3,0,0,0,0,0,0,0,0,0,0,0,0],
    [0,0,0,0,0,0,0,0,0,0,0,1,1,1,0,0,0,0,0,0,0,0,0,0,0,0],
    [0,0,0,0,0,0,0,0,0,0,0,1,6,1,0,0,0,0,0,0,0,0,0,0,0,0],
    [0,0,0,0,0,0,0,0,0,0,0,1,1,1,0,0,0,0,0,0,0,0,0,0,0,0]
  ],

  "specialRules": {
    "maxEnemiesOnScreen": 3,
    "baseProtection": false,
    "timeLimit": 0,
    "powerUpChance": 0.18
  },

  "tips": [
    "水域會阻擋坦克但不阻擋子彈",
    "小心冰地上的滑行效果",
    "利用地形優勢對抗敵人",
    "強化坦克需要 2 發子彈才能摧毀"
  ]
}
