{
  "levelNumber": 1,
  "name": "Level 1 - 新手訓練",
  "difficulty": "easy",
  "description": "第一關，熟悉遊戲操作",

  "map": [
    [0,0,0,0,0,0,0,0,0,0,0,0,0,0,0,0,0,0,0,0,0,0,0,0,0,0],
    [0,0,0,0,0,0,0,0,0,0,0,0,0,0,0,0,0,0,0,0,0,0,0,0,0,0],
    [0,0,1,1,0,0,1,1,0,0,1,1,0,0,1,1,0,0,1,1,0,0,1,1,0,0],
    [0,0,1,1,0,0,1,1,0,0,1,1,0,0,1,1,0,0,1,1,0,0,1,1,0,0],
    [0,0,1,1,0,0,1,1,0,0,1,1,0,0,1,1,0,0,1,1,0,0,1,1,0,0],
    [0,0,1,1,0,0,1,1,0,0,1,1,2,2,1,1,0,0,1,1,0,0,1,1,0,0],
    [0,0,1,1,0,0,1,1,0,0,1,1,2,2,1,1,0,0,1,1,0,0,1,1,0,0],
    [0,0,1,1,0,0,1,1,0,0,1,1,0,0,1,1,0,0,1,1,0,0,1,1,0,0],
    [0,0,1,1,0,0,1,1,0,0,0,0,0,0,0,0,0,0,1,1,0,0,1,1,0,0],
    [0,0,1,1,0,0,1,1,0,0,0,0,0,0,0,0,0,0,1,1,0,0,1,1,0,0],
    [0,0,0,0,0,0,0,0,0,0,1,1,0,0,1,1,0,0,0,0,0,0,0,0,0,0],
    [0,0,0,0,0,0,0,0,0,0,1,1,0,0,1,1,0,0,0,0,0,0,0,0,0,0],
    [0,0,1,1,0,0,1,1,2,2,0,0,0,0,0,0,2,2,1,1,0,0,1,1,0,0],
    [0,0,1,1,0,0,1,1,2,2,0,0,0,0,0,0,2,2,1,1,0,0,1,1,0,0],
    [0,0,0,0,0,0,0,0,0,0,1,1,0,0,1,1,0,0,0,0,0,0,0,0,0,0],
    [0,0,0,0,0,0,0,0,0,0,1,1,1,1,1,1,0,0,0,0,0,0,0,0,0,0],
    [0,0,1,1,0,0,1,1,0,0,0,0,0,0,0,0,0,0,1,1,0,0,1,1,0,0],
    [0,0,1,1,0,0,1,1,0,0,0,0,0,0,0,0,0,0,1,1,0,0,1,1,0,0],
    [0,0,1,1,0,0,1,1,0,0,1,1,0,0,1,1,0,0,1,1,0,0,1,1,0,0],
    [0,0,1,1,0,0,1,1,0,0,1,1,0,0,1,1,0,0,1,1,0,0,1,1,0,0],
    [0,0,1,1,0,0,1,1,0,0,1,1,0,0,1,1,0,0,1,1,0,0,1,1,0,0],
    [0,0,1,1,0,0,1,1,0,0,1,1,0,0,1,1,0,0,1,1,0,0,1,1,0,0],
    [0,0,1,1,0,0,1,1,0,0,0,0,0,0,0,0,0,0,1,1,0,0,1,1,0,0],
    [0,0,0,0,0,0,0,0,0,0,0,1,1,1,1,0,0,0,0,0,0,0,0,0,0,0],
    [0,0,0,0,0,0,0,0,0,0,0,1,6,6,1,0,0,0,0,0,0,0,0,0,0,0],
    [0,0,0,0,0,0,0,0,0,0,0,1,6,6,1,0,0,0,0,0,0,0,0,0,0,0]
  ],

  "playerSpawn": {
    "x": 8,
    "y": 24,
    "direction": "up"
  },

  "basePosition": {
    "x": 12,
    "y": 24
  },

  "enemySpawns": [
    { "x": 0, "y": 0, "id": "spawn_left" },
    { "x": 12, "y": 0, "id": "spawn_center" },
    { "x": 24, "y": 0, "id": "spawn_right" }
  ],

  "enemyWaves": [
    { "type": "BASIC", "count": 15, "spawnInterval": 3000 },
    { "type": "FAST", "count": 3, "spawnInterval": 3000 },
    { "type": "POWER", "count": 2, "spawnInterval": 4000 }
  ],

  "powerUpSpawns": [
    { "type": "STAR", "triggerEnemyCount": 10, "position": "random" },
    { "type": "HELMET", "triggerEnemyCount": 5, "position": "random" }
  ],

  "specialRules": {
    "maxEnemiesOnScreen": 3,
    "baseProtection": false,
    "timeLimit": 0,
    "hasBonus": false,
    "enemyFireRate": 0.8,
    "playerInvincible": false
  },

  "metadata": {
    "author": "Tank Battle Team",
    "version": "1.0",
    "createdAt": "2025-11-09",
    "tags": ["tutorial", "easy", "classic"],
    "notes": "第一關，用於教學，敵人較少且較弱"
  }
}
